12 16 2 18 1
0	1	2	3	1	1	1	1	4	5	6	7	2	3	0	0
0	1	2	3	1	1	1	1	5	1	8	9	2	3	0	0
0	1	2	3	1	1	4	5	1	1	10	11	2	3	0	0
0	1	2	3	1	1	5	1	1	1	12	13	2	3	0	0
0	0	2	3	4	5	8	9	14	15	1	1	2	3	0	0
0	0	0	0	0	0	0	0	0	0	1	1	2	3	0	0
0	0	2	3	10	11	1	1	1	1	1	1	2	3	0	0
0	0	2	3	12	13	1	1	1	1	16	0	0	0	0	0
17	7	2	3	1	1	1	1	4	5	1	1	6	7	0	0
18	19	2	3	1	1	1	1	5	1	1	1	8	9	0	0
20	21	2	3	8	9	4	5	14	15	14	15	8	9	0	0
0	0	0	0	0	0	0	0	0	0	0	0	0	0	0	0