24 50 4 18 2 32 5
0 0 1 2 3 3 3 3 1 2 4 4 4 4 4 4 4 4 4 4 4 4 4 4 4 4 4 4 4 4 4 4 4 4 4 4 4 4 4 4 4 4 4 4 4 4 0 0 5 5
0 0 6 1 3 3 3 3 6 1 4 4 4 4 4 4 4 4 4 4 4 4 4 4 4 4 4 4 4 4 4 4 4 4 4 4 4 4 4 4 4 4 4 4 4 4 0 0 5 5
0 0 3 3 3 3 7 8 3 3 4 4 4 4 4 4 3 9 3 9 4 4 4 4 4 4 4 4 10 11 4 4 4 4 4 4 4 4 4 4 4 4 3 9 3 9 0 0 5 5
0 0 3 3 3 3 12 13 3 3 4 4 4 4 4 4 3 3 3 3 4 4 4 4 4 4 4 4 14 15 4 4 4 4 4 4 4 4 4 4 16 17 3 3 3 3 0 0 5 5
0 0 3 3 3 3 1 2 3 3 4 4 4 4 10 11 18 19 20 21 10 11 4 4 4 4 4 4 22 23 3 9 3 9 3 9 3 9 24 17 25 25 7 8 3 3 0 0 5 5
0 0 3 3 3 3 6 1 3 3 4 4 4 4 14 15 26 4 4 27 14 15 4 4 4 4 4 4 28 3 3 3 3 3 3 3 3 3 25 25 25 25 12 13 3 3 25 29 5 5
0 0 3 3 7 8 22 23 0 0 4 4 20 21 0 0 4 4 4 4 3 3 10 11 10 11 3 9 30 31 3 3 3 3 0 0 32 33 1 2 7 8 3 3 3 3 25 34 5 5
0 0 3 3 12 13 28 3 0 0 4 4 4 27 3 3 35 36 4 4 3 3 14 15 14 15 3 3 37 38 0 0 3 3 39 1 40 32 6 1 12 13 3 3 0 0 25 41 5 5
0 0 3 3 22 23 3 3 3 3 24 17 24 17 7 8 1 2 1 2 3 3 3 3 22 23 0 0 1 2 10 11 3 3 18 19 20 21 32 33 3 3 3 3 1 2 0 0 5 5
0 0 3 3 28 3 3 3 3 3 25 25 25 25 12 13 6 1 6 1 3 3 3 3 28 3 39 1 6 1 14 15 3 3 26 4 4 27 40 32 3 3 0 0 6 1 0 0 5 5
0 0 0 0 42 0 7 8 7 8 0 0 0 0 0 0 0 0 0 0 10 11 0 0 3 3 4 4 0 0 3 3 3 3 4 4 10 11 0 0 0 0 3 3 3 3 0 0 5 5
0 0 0 0 1 43 12 13 12 13 3 3 39 1 39 1 39 1 3 3 14 15 39 1 3 3 35 36 39 1 0 0 0 0 35 36 14 15 39 1 39 1 3 3 3 3 0 0 5 5
5 5 0 0 0 0 32 33 3 3 7 8 3 3 44 45 30 31 0 0 0 0 0 0 0 0 0 0 0 0 0 0 0 0 0 0 0 0 0 0 0 0 0 0 0 0 18 19 46 47
5 5 0 0 39 1 40 32 3 3 12 13 3 3 44 45 37 38 39 1 39 1 39 1 39 1 3 3 3 3 39 1 3 3 39 1 39 1 3 3 39 1 3 3 39 1 26 4 46 47
5 5 0 0 1 2 3 3 32 33 3 3 3 3 44 45 48 49 1 2 18 19 20 21 1 2 7 8 18 19 20 21 30 31 1 2 18 19 20 21 7 8 18 19 20 21 10 11 46 47
5 5 0 0 6 1 3 3 40 32 3 3 3 3 44 45 50 51 6 1 26 4 4 27 6 1 12 13 26 4 4 27 37 38 6 1 26 4 4 27 12 13 26 4 4 27 14 15 46 47
5 5 0 0 3 3 3 3 3 3 32 33 7 8 44 45 1 2 7 8 4 4 4 4 7 8 1 2 52 4 24 17 48 49 3 3 52 4 4 4 1 2 4 4 4 4 1 2 46 47
5 5 0 0 3 3 3 3 3 3 40 32 12 13 44 45 6 1 12 13 53 54 16 17 12 13 6 1 55 4 25 25 50 51 3 3 55 4 56 4 6 1 53 54 16 17 6 1 46 47
5 5 0 0 7 8 3 3 0 0 0 0 0 0 44 45 10 11 1 2 10 11 24 17 1 2 7 8 57 4 25 25 1 2 3 3 57 4 57 4 7 8 4 4 25 25 3 3 0 0
5 5 0 0 12 13 3 3 39 1 39 1 39 1 44 45 14 15 6 1 14 15 25 25 6 1 12 13 58 4 25 25 6 1 3 3 58 4 58 4 12 13 53 54 25 25 3 3 25 29
5 5 0 0 0 0 3 3 7 8 3 3 1 2 44 45 1 2 7 8 0 0 1 2 3 3 3 3 0 0 1 2 7 8 3 3 1 2 1 2 1 2 1 2 3 3 3 3 25 34
5 5 0 0 39 1 3 3 12 13 3 3 6 1 44 45 6 1 12 13 39 1 6 1 3 3 3 3 39 1 6 1 12 13 3 3 6 1 6 1 6 1 6 1 3 3 3 3 25 41
5 5 0 0 3 3 0 0 0 0 3 3 3 3 44 45 3 3 3 3 3 3 3 3 3 3 3 3 3 3 3 3 3 3 3 3 3 3 3 3 3 3 3 3 0 0 0 0 0 0
5 5 0 0 3 3 39 1 39 1 0 0 0 0 0 0 0 0 0 0 0 0 0 0 0 0 0 0 0 0 0 0 0 0 0 0 0 0 0 0 0 0 0 0 0 0 0 0 0 0